{
    "segments":[
        [
            [1,1,1,1,0,0,1,1,1,1],
            [1,0,0,0,0,0,0,0,0,1],
            [1,0,0,0,0,0,0,0,0,1],
            [1,0,0,0,0,0,0,0,0,1],
            [0,0,0,0,0,0,0,0,0,0],
            [0,0,0,0,0,0,0,0,0,0],
            [1,0,0,0,0,0,0,0,0,1],
            [1,0,0,0,0,0,0,0,0,1],
            [1,0,0,0,0,0,0,0,0,1],
            [1,1,1,1,0,0,1,1,1,1]
        ],
        [
            [1,1,1,1,0,0,1,1,1,1],
            [1,1,1,1,0,0,1,1,1,1],
            [1,1,1,1,0,0,1,1,1,1],
            [1,1,1,1,0,0,1,1,1,1],
            [1,1,1,1,0,0,1,1,1,1],
            [1,1,1,1,0,0,1,1,1,1],
            [1,1,1,1,0,0,1,1,1,1],
            [1,1,1,1,0,0,1,1,1,1],
            [1,1,1,1,0,0,1,1,1,1],
            [1,1,1,1,0,0,1,1,1,1]
        ],
        [
            [1,1,1,1,1,1,1,1,1,1],
            [1,0,0,0,0,0,0,0,0,1],
            [1,0,0,0,0,0,0,0,0,1],
            [1,1,1,1,1,1,1,1,1,1],
            [0,0,0,0,0,0,0,0,0,0],
            [0,0,0,0,0,0,0,0,0,0],
            [1,1,1,1,1,1,1,1,1,1],
            [1,0,0,0,0,0,0,0,0,1],
            [1,0,0,0,0,0,0,0,0,1],
            [1,1,1,1,1,1,1,1,1,1]
        ]
        
    ],
    "levels":[
        {
            "width":50,
            "height":50
        }
    ]
}